NO ./SRC/TEXTURES/42akdemir.xpm
WE ./SRC/TEXTURES/42ctasar.xpm
SO ./SRC/TEXTURES/42hozkaya.xpm
EA ./SRC/TEXTURES/42relvan.xpm

F 0,0,0
C 255,255,255

11111111111111111111111
10000000000000000000011
10000000000000000000011
10000000000000000000011
10000000000000000000011
10000000000000000000011
100000000111110000000001
100000000100010000000011
100000000110110000000011
10000000011S11000000011
10000000000000000000011
10000000000000000000001
10000000000000000000011
10000000000000000000011
10000000000000000000011
10000000000000000000011
11111111111111111111111