NO ./SRC/TEXTURES/blue_bricks.xpm
WE           ./SRC/TEXTURES/carpet.xpm
SO       ./SRC/TEXTURES/eagle.xpm
EA ./SRC/TEXTURES/wood.xpm

C 255, 51, 51
F     10         ,0  , 102

111111111111111111111 1
11100001111111111111  1
1110N00111111111111  11
111000011111111111  111
11111111111111111  1111
1111111111111111  11111
111111111111111  110011
11111111111111  1110011
1111111111111  11111111