        NO                 ./SRC/TEXTURES/grid0.xpm




                   WE                                   ./SRC/TEXTURES/grid0.xpm
             C                     225   ,30    ,0


                     EA      ./SRC/TEXTURES/grid0.xpm
        F               220,255,0 
 

 SO ./SRC/TEXTURES/grid0.xpm






   
        1111     1111    1111111       1111    111            
    1111111111111111111111111
        111111100011000000011
111111111111110000000000001         1
100100000000000000000000111111111
111111111011000001110000000000001
100000000011000001110111111111111
11111111111111111111111111111
1111111111111
11111111111111111111111111111
11110111111111011100000010001
11110111111111011101010010001
11000000110101011100010001
10000000000000001100000010001
1000000000000001101010010001
11000001110101011111011100N11

