        NO                 ./SRC/TEXTURES/grid0.xpm




                   WE                                   ./SRC/TEXTURES/grid0.xpm
             C                     225   ,30    ,0


                     EA      ./SRC/TEXTURES/grid0.xpm
        F               220,255,0 
 

 SO ./SRC/TEXTURES/grid0.xpm





11111111
11000111
11100011
11111111111111111111111
11110000111011111N111
111111111111111111111
              
 111111111111111111111111
10000001
11111111    