NO ./SRC/TEXTURES/bonewall.xpm
WE ./SRC/TEXTURES/carpet.xpm
SO ./SRC/TEXTURES/bonewall.xpm
EA ./SRC/TEXTURES/floorboard.xpm

C 157, 215, 239
F     12    ,31  , 10

1111111111111111111111
1000000000000000000001
1000000000000000000001
1000000010000000000001
1000000000000000000001
1000N00000000000000001
1000000000001000000001
1000000000001000000001
1111111111111111111111
