NO ./SRC/TEXTURES/white.xpm
WE ./SRC/TEXTURES/red.xpm
SO ./SRC/TEXTURES/blue.xpm
EA ./SRC/TEXTURES/black.xpm

C 157, 215, 239
F     12    ,31  , 10

1111111111111111111111
1000000000000000000001
1000000000000000000001
1000S00000000000000001
1000000000000000000001
1000000000000000000001
1111111111111111111111
