NO ./SRC/TEXTURES/blue_bricks.xpm
WE ./SRC/TEXTURES/red_bricks.xpm
SO ./SRC/TEXTURES/hitler.xpm
EA ./SRC/TEXTURES/wood.xpm

C 157, 25, 34
F     11    ,31  , 100

1111111111111111111111
1000000000000000000001
100000000000000000001
1000000010000000000001
100010000000000000N001
100000000000000000001
100000000000100000111
1111111111111110111