NO ./SRC/TEXTURES/blue_bricks.xpm
WE ./SRC/TEXTURES/carpet.xpm
SO ./SRC/TEXTURES/eagle.xpm
EA ./SRC/TEXTURES/wood.xpm

C 15, 25, 34
F     1   1    ,25  , 10

1111111111111111111111
1000000000000000000001
1000000000000000000001
1000000010000000000001
1000100000000000000001
1000N00000000000000001
100000000000100000001111111
1000000000001000000000000101
1111111111111111110111111111
11111111          1