NO ./SRC/TEXTURES/blue_bricks.xpm
WE ./SRC/TEXTURES/red_bricks.xpm
SO ./SRC/TEXTURES/stone.xpm
EA ./SRC/TEXTURES/wood.xpm

C 232   ,   123, 12
F     12    ,31  , 10

 1111111111111111111111
11111111100000N000001
1100000000000100000111
 11111111111111111111
  11111111111111111111

