NO      ./SRC/TEXTURES/blue_bricks.xpm 
 WE      ./SRC/TEXTURES/red_bricks.xpm   

C     25  ,   123, 12
      SO      ./SRC/TEXTURES/stone.xpm

EA     ./SRC/TEXTURES/wood.xpm   

F     12    ,31  , 10

 1111111111111111111111
111111111000000000001
1100000000000100000111
11111111111111111111  
              10011  
   1111111111110N00111111 
1111111111111111111