NO ./SRC/TEXTURES/grid0.xpm
WE ./SRC/TEXTURES/grid1.xpm
SO ./SRC/TEXTURES/grid2.xpm
EA ./SRC/TEXTURES/grid3.xpm

C 0   ,   123, 12
F 255   ,   255, 0

 1111111111111111111111
11111111100000N000001
1100000000000100000111
 11111111111111111111
  11111111111111111111
