NO ./SRC/TEXTURES/blue_bricks.xpm
WE ./SRC/TEXTURES/red_bricks.xpm
SO ./SRC/TEXTURES/stone.xpm
EA ./SRC/TEXTURES/wood.xpm

F 220,100,0
C 225,30,0

11111111111 11111111111111111        
100000000011100000000000011        11111
1011000001110000000000001
100100000000000000000000111111111
111111111011000001110000000000001 111111
11110111 1 111011100000010001111
11110111111111011101010010001
11000000110101011100000000001
10000000000000000000000010001
10000000000000001101010010001
11000001110101011111011110N01111111
11110111 1110101 101111010001 111111111
11111111111111111111111111111111