NO ./SRC/TEXTURES/grid0.xpm
WE ./SRC/TEXTURES/grid1.xpm
SO ./SRC/TEXTURES/grid2.xpm
EA ./SRC/TEXTURES/grid3.xpm

F 6,56 ,255
C 74, 34,39


1111111
1001011
1010011
11000N1
1111111
