NO ./SRC/TEXTURES/blue_bricks.xpm
WE ./SRC/TEXTURES/red_bricks.xpm
SO ./SRC/TEXTURES/stone.xpm
EA ./SRC/TEXTURES/wood.xpm

F 220,100,0
C 225,30,0

1 111111111111111111  1
1  1111110000111111  11
11  111110000111111  11
111  1111000011111  111
1111  11111111111 11111
11111  111111111  11111
111111  1111111  110011
1111111  11111   1110011
11111111  111 11110011
111111111     11111N011
11111111  111 11110011
1111111  11111  1110011
111111  11111111  110011
11111  111111111  11111
1111 11111111111  1111
111  11111111111111  111
11  111111111111111  11
1  1111111111111111  11
1 1111111111111111111 11