NO ./SRC/TEXTURES/blue_bricks.xpm
WE ./SRC/TEXTURES/red_bricks.xpm
SO ./SRC/TEXTURES/stone.xpm
EA ./SRC/TEXTURES/wood.xpm

F 6,56 ,255
C 74, 34,39


        1111111111111111111111111
        1000000000110000000000001
        1011000001110000000000001
        100100000000000000N0000001
         1111111111111111111111111