NO ./SRC/TEXTURES/grid0.xpm
WE ./SRC/TEXTURES/grid1.xpm
SO ./SRC/TEXTURES/grid2.xpm
EA ./SRC/TEXTURES/grid3.xpm

F 6,56 ,255
C 74, 34,39


        N
        1000000000110000000000001
        1011000001110000000000001
        1001000000000000000000001
111111111011000001110000000000001
100000000011000001110111111111111
11110111111111011100000010001
11110111111111011101010000001
11000000110101011100000010001
10000000000000001100000010001
10000000000000001101010010001
1100000111010101111101111000111
11110111 1110101 101111010001
11111111 1111111 111111111111

111111
100001
000000