NO ./SRC/TEXTURES/blue_bricks.xpm
WE           ./SRC/TEXTURES/carpet.xpm
SO       ./SRC/TEXTURES/carpet.xpm
EA ./SRC/TEXTURES/wood.xpm

C 255, 51, 51
F     10         ,0  , 102

111111111111
111000011111
1110N0011111
111000011111
111111111111 
1111   01111 
1111   11111 
1111   11111 