NO ./src/textures/blue_bricks.xpm
WE           ./src/textures/carpet.xpm
SO       ./src/textures/carpet.xpm
EA ./src/textures/wood.xpm

C 255, 51, 51
F     10         ,0  , 102

11111111111111111111111
10001111000001111100011
11000111000001111000111
11100011111111110001111
11110001111111100011111
11111000111111000100011
11111100011110001110001
11111110001100011000111
11111111000N00111000111
11111110001100011000111
11111100011110001100011
11111000111111000110001
11110001000001100011111
11100011000001110001111
11000111000001111000111
10001111000001111100011
11111111111111111111111